month,revenue,expenses,profits,cashflow,capital_need
1,25000,20000,5000,0.2,500
2,26000,21000,5000,0.19,500
3,27000,21500,5500,0.2,0
4,28000,22000,6000,0.21,0
5,29000,22500,6500,0.22,0
6,30000,23000,7000,0.23,0
7,32000,24000,8000,0.25,0
8,34000,25000,9000,0.26,0
9,35000,26000,9000,0.25,0
10,34000,27000,7000,0.21,0
11,36000,28000,8000,0.22,0
12,38000,30000,8000,0.21,0